####################
#.#.....#.......##.
#...###.#.#####....#
#.###.#...#.#.#.####
#.#...#.#.#.#.###..#
#.###.#####.#..##.##
#...#.......#......#
#.#.#.####..##.#####
###.#..#.##........#
#...#.##....########
#.###.#####......#.#
#.#.#...#.#.##.###.#
#.#.###...#.#.##.###.#
#...#.#.#######.####
###.#.#.#..........#
#...#.#.#######.####
#.#.#.#...#......#.#
#.#.#.###.#.######.#
#.#................#
#.##################