####################
##.#.#.#...#.#......
#..#.#...#...#.##.##
#.##.#.#####.#.#...#
#..#.......#.###.###
##.#.#####.#.....#.#
#........#.#######.#
###.######..#......#
#.......###.##.###.#
#.##.####....#.....#
#..#...##.########.#
#.##.#..#.#.#..#.#.#
#########.#.#..#.#.#
#.........#.##.#...#
#.#########..#.###.#
#.....#.#.##...#...#
#####.#...#..#.#.#.#
#...#.###.##.#####.#
#.#................#
#.##################
