####################
#.##.#......#....#..
#....#.###.##.####.#
####.#.#.#....#....#
##.#.#.#.#.####.####
#..#...#.#.#.......#
#.###.##.#.#######.#
#..........#.#.....#
#.######.#.#.#####.#
#......#.#...#...#.#
##.#.#.#######.#...#
####.#.....#.#.#####
#.#..#####.#.#.....#
#.##.....#...#####.#
#..#.###.#.#.#...#.#
#.##.#.#.#.###.#.#.#
#..#.#...#.#...#.#.#
#.######.#.##.####.#
#........#.........#
#.##################
